"filename", "language", "Java", "Markdown", "comment", "blank", "total"
"/Users/yuhyunkim/Documents/APCOMPSCIPROJECT/HackerGame/HackerGame/README.md", "Markdown", 0, 2, 0, 1, 3
"/Users/yuhyunkim/Documents/APCOMPSCIPROJECT/HackerGame/HackerGame/bin/main/Main.class", "Java", 10, 0, 0, 0, 10
"/Users/yuhyunkim/Documents/APCOMPSCIPROJECT/HackerGame/HackerGame/bin/main/Player.class", "Java", 89, 0, 12, 0, 101
"/Users/yuhyunkim/Documents/APCOMPSCIPROJECT/HackerGame/HackerGame/bin/main/Utils/MathUtil.class", "Java", 13, 0, 0, 0, 13
"/Users/yuhyunkim/Documents/APCOMPSCIPROJECT/HackerGame/HackerGame/bin/main/manager/CommandManager.class", "Java", 26, 0, 0, 0, 26
"/Users/yuhyunkim/Documents/APCOMPSCIPROJECT/HackerGame/HackerGame/bin/main/manager/GameManager.class", "Java", 75, 0, 0, 1, 76
"/Users/yuhyunkim/Documents/APCOMPSCIPROJECT/HackerGame/HackerGame/bin/main/manager/UIManager.class", "Java", 99, 0, 0, 3, 102
"/Users/yuhyunkim/Documents/APCOMPSCIPROJECT/HackerGame/HackerGame/bin/main/option/Action.class", "Java", 4, 0, 0, 1, 5
"/Users/yuhyunkim/Documents/APCOMPSCIPROJECT/HackerGame/HackerGame/bin/main/option/Option.class", "Java", 21, 0, 0, 0, 21
"/Users/yuhyunkim/Documents/APCOMPSCIPROJECT/HackerGame/HackerGame/bin/main/option/OptionPath.class", "Java", 344, 0, 0, 1, 345
"/Users/yuhyunkim/Documents/APCOMPSCIPROJECT/HackerGame/HackerGame/bin/main/option/Options.class", "Java", 18, 0, 0, 0, 18
"/Users/yuhyunkim/Documents/APCOMPSCIPROJECT/HackerGame/HackerGame/src/main/Main.java", "Java", 7, 0, 0, 3, 10
"/Users/yuhyunkim/Documents/APCOMPSCIPROJECT/HackerGame/HackerGame/src/main/Player.java", "Java", 230, 0, 1, 76, 307
"/Users/yuhyunkim/Documents/APCOMPSCIPROJECT/HackerGame/HackerGame/src/main/Utils/MathUtil.java", "Java", 7, 0, 0, 2, 9
"/Users/yuhyunkim/Documents/APCOMPSCIPROJECT/HackerGame/HackerGame/src/main/manager/CommandManager.java", "Java", 29, 0, 0, 9, 38
"/Users/yuhyunkim/Documents/APCOMPSCIPROJECT/HackerGame/HackerGame/src/main/manager/GameManager.java", "Java", 127, 0, 0, 44, 171
"/Users/yuhyunkim/Documents/APCOMPSCIPROJECT/HackerGame/HackerGame/src/main/manager/UIManager.java", "Java", 157, 0, 2, 48, 207
"/Users/yuhyunkim/Documents/APCOMPSCIPROJECT/HackerGame/HackerGame/src/main/option/Action.java", "Java", 5, 0, 0, 2, 7
"/Users/yuhyunkim/Documents/APCOMPSCIPROJECT/HackerGame/HackerGame/src/main/option/Option.java", "Java", 34, 0, 0, 9, 43
"/Users/yuhyunkim/Documents/APCOMPSCIPROJECT/HackerGame/HackerGame/src/main/option/OptionPath.java", "Java", 342, 0, 79, 162, 583
"/Users/yuhyunkim/Documents/APCOMPSCIPROJECT/HackerGame/HackerGame/src/main/option/Options.java", "Java", 24, 0, 0, 8, 32
"Total", "-", 1661, 2, 94, 370, 2127